%%%%%%%%%%%%%%%%%%%%%%%%%%%%%%%%%%%%
%               P%%P               %
% %%%%%%%%%%%%%%%%%%%%%%%%%%%%%%%% %
% %........%.....%%.....%........% %
% %........%.....%%.....%........% %
% % .......%%%.%%%%%%.%%%%%.%%%%%% %
%  .........                       %
%%%........% %%%%%% %%%.%%% %%.%%%%%
%%%%%%%%.%%% %%%%%% %.....% %......%
%.......         %% %.....% %......%
%......% %%%.%%%    %.....% %......%
%......% %.....%    %%%.%%% %......%
%......% %.....% %%         .......%
%......% %.....% %%%%%% %%%.%%%%%%%%
%%%%% %% %%%.%%% %%%%%% %........%%%
%                       .........  %
% %%%%%%.%%%%%.%%%%%%.%%%........% %
% %........%.....%%.....%........% %
% %........%.....%%.....%........% %
% %%%%%%%%%%%%%%%%%%%%%%%%%%%%%%%% %
%               P%%P               %
%%%%%%%%%%%%%%%%%%%%%%%%%%%%%%%%%%%%