%%%%%%%%%%%%%%%%%%%%%%%%%%%%%%%%
%                              %
%                              %
%                              %
%                              %
%                              %
%                              %
%                              %
%                              %
%                              %
%                              %
%                              %
%                  %%%/%%%%    %
%                  %AAAAAA%    %
%                  %%%%%%%%    %
%                              %
%                              %
%                              %
%                              %
%%%%%%%%%%%%%%%%%%%%%%%%%%%%%%%%
