%%%%%%%%%%%%%%%%%%%%%%%%%%%%%%%%%%%%%%%%%
%                                       %
%                                       %
%                                       %
%                                       %
%                                       %
%                                       %
%                                       %
%                                       %
%                                       %
%                                       %
%                                       %
%                                       %
%                                       %
%                                       %
%                                       %
%                                       %
%                                       %
%                                       %
%%%%%%%%%%%%%%%%%%%%%%%%%%%%%%%%%%%%%%%%%