%%%%%%%%%%%%%%%%%%%%%%%%%%%%%%%%%%%%%%%%%%%%%%%%%%%%%%%%%%%%%%%%%%%%%%%%%%%%%%%%
%    %         %                         %        %     %       %     %        %
%    %%%%%%%%%%%                         %        %     %%%%%%%%%     %        %
%                                        %        %                   %        %
%                                        %%%%%%%%%%                   %%%%%%%%%%
%                                                                              %
%                                                                              %
%%%%%%%  %%%%%%%%%%%%%%%%%%%%%%%%%%%%             %                   %        %
%     %  %       %         %        %             %                   %        %
%     %  %       %         %        %      D      %%%%%%%%%%%%%%%%%%%%%        %
%     %  %       %         %        %                                          %
%     %  %       %         %        %                                          %
%     %  %       %         %        %                                          %
%%%%%%%  %%%%%%%%%         %%%%%%%%%%     %%%%%%%%%%%%%%%%     %%%%%%%%%%%%%%%%%
%     %  %       %         %        %     %              %     %              %%
%     %  %       %         %        %     %              %     %              %%
%     %  %       %         %        %     %              %     %              %%
%     %  %       %         %        %     %              %     %              %%
%     %  %       %         %        %     %              %     %              %%
%     %  %       %         %        %     %              %     %              %%
%%%%%%%  %%%%%%%%%%%%%%%%%%%%%%%%%%%%     %%%%%%%%%%%%%%%%%%%%%%%%%%%%%%%%%%%%%%
%                                                                              %
%                                                                              %
%%%%%%%%%%%%%%%%%%%%%%%%%%%%%%%%%%%%%%%%%%%%%%%%%%%%%%%%%%%%%%%%%%%%%%%%%%%%%%%%
%        %       %         %       %       %       %                %       %  %
%        %       %         %       %       %       %                %       %  %
%        %       %         %       %       %       %                %       %  %
%        %       %         %       %       %       %                %       %  %
%        %       %         %       %       %       %                %       %  %
%        %       %         %       %       %       %                %       %  %
%%%%%%%%%%%%%%%%%%%%%%%%%%%%%%%%%%%%%%%%%%%%%%%%%%%%%%%%%%%%%%%%%%%%%%%%%%%%%%%%