%%%%%%%%%%%%%%%%%%%%%%%%%%%%%%%%%%%%%%%%%%%%%%%%%%%%%%%%%%%%%%%%%%%%%%%%%%%%%%%%%%%%%%%%%%%%%%%%%%%%%%%%%%%%%%%%%%%%%%%%
%    %         %                         %        %     %       %     %        %                        %         %    %
%    %%%%%%%%%%%                         %        %     %%%%%%%%%     %        %                        %%%%%%%%%%%    %
%                                        %        %                   %        %                                       %
%   D                                    %%%%%%%%%%                   %%%%%%%%%%                                       %
%                                                                                                                      %
%                                                                                                                      %
%%%%%%%  %%%%%%%%%%%%%%%%%%%%%%%%%%%%             %                   %             %%%%%%%%%%%%%%%%%%%%%%%%%%%%%%%%%%%%
%     %  %       %         %        %             %                   %             %       %            %             %
%     %  %       %         %        %             %%%%%%%%%%%%%%%%%%%%%             %       %            %             %
%     %  %       %         %        %                                               %       %            %             %
%     %  %       %         %        %                                               %       %            %             %
%     %  %       %         %        %                                               %       %            %             %
%%%%%%%  %%%%%%%%%         %%%%%%%%%%     %%%%%%%%%%%%%%%%     %%%%%%%%%%%%%%%%     %%%%%%%%%            %             %
%     %  %       %         %        %     %              %     %              %     %       %            %             %
%     %  %       %         %        %     %              %     %              %     %       %            %             %
%     %  %       %         %        %     %              %     %              %     %       %            %             %
%     %  %       %         %        %     %              %     %              %     %       %            %             %
%     %  %       %         %        %     %              %     %              %     %       %            %             %
%     %  %       %         %        %     %              %     %              %     %       %            %             %
%%%%%%%  %%%%%%%%%%%%%%%%%%%%%%%%%%%%     %%%%%%%%%%%%%%%%%%%%%%%%%%%%%%%%%%%%%     %%%%%%%%%%%%%%%%%%%%%%             %
%                                                                                                        %             %
%                                                                                                        %             %
%%%%%%%%%%%%%%%%%%%%%%%%%%%%%%%%%%%%%%%%%%%%%%%%%%%%%%%%%%%%%%%%%%%%%%%%%%%%%%%%%%%%%%%%%%%%%%%%%%%%%%%%%%             %
%        %       %         %       %       %       %                %       %       %       %            %             %
%        %       %         %       %       %       %                %       %       %       %            %             %
%        %       %         %       %       %       %                %       %       %       %            %             %
%        %       %         %       %       %       %                %       %       %       %            %             %
%        %       %         %       %       %       %                %       %       %       %            %             %
%        %       %         %       %       %       %                %       %       %       %            %             %
%%%%%%%%%%%%%%%%%%%%%%%%%%%%%%%%%%%%%%%%%%%%%%%%%%%%%%%%%%%%%%%%%%%%%%%%%%%%%%%%%%%%%%%%%%%%%%%%%%%%%%%%%%%%%%%%%%%%%%%%