%%%%%%%%%%%%%%%%%%%%%%%%%%%%%%%%%%%%%%%%%%%%%%%%%%%%%%%%%%%%%%%%%%%%%%%%%%%%%%%%%%%%%%%%%%%%%%%%%%%%%%%%%%%%%%%%%%%%%%%%
%    %         %                         %        %     %       %     %        %                        %         %    %
%    %%%%%%%%%%%                         %        %     %%%%%%%%%     %        %                        %%%%%%%%%%%    %
%                                        %        %                   %        %                                       %
%   D                                    %%%%%%%%%%                   %%%%%%%%%%                                       %
%                                                                                                                      %
%                                                                                                                      %
%%%%%%%  %%%%%%%%%%%%%%%%%%%%%%%%%%%%             %                   %             %%%%%%%%%%%%%%%%%%%%%%%%%  %%%  %%%%
%     %  %       %         %        %             %                   %             %       %            %      %      %
%     %  %       %         %        %             %%%%%%%%%%%%%%%%%%%%%                     %            %      %      %
%     %  %       %         %        %                                                       %            %      %      %
%                %         %        %                                               %       %            %      %      %
%                %         %        %                                               %       %            %      %      %
%%%%%%%  %%%%%%%%%         %%%%%%%%%%     %%%%%%%%%%%%%%%%     %%%%%%%%%%%%%%%%     %%%%%%%%%            %%%%%%%%%%%%%%%
%                %         %        %     %              %     %              %     %       %            %      %      %
%                %         %        %     %              %     %              %     %       %            %      %      %
%     %  %       %         %        %     %              %     %              %             %            %      %      %
%     %  %       %         %        %     %              %     %              %             %            %      %      %
%     %  %       %         %        %     %              %     %              %     %       %            %      %      %
%     %  %       %         %        %     %              %     %              %     %       %            %      %      %
%%%%%%%  %%%%%%%%%%%%%%%%%%%%%%%%%%%%     %%  %%%%%%%%%%%%%%%%%%%%%%%%%%%%%  %%     %%%%%%%%%%%%%%%%%%%%%%      %      %
%                                                                                                               %%%%%%%%
%                                                                                                               %      %
%%%%%%%  %%%%%%  %%%%%%%%%%%%%%%%  %%%%%%  %  %%%%%%%%%%%%%%%%%%%%%%%%%%%%  %  %%%%%%  %%%%%%  %%%%%%%%%%%      %      %
%        %       %         %       %       %       %                %       %       %       %            %      %      %
%        %       %         %       %       %       %                %       %       %       %            %      %      %
%        %       %         %       %       %       %                %       %       %       %            %      %      %
%        %       %         %       %       %       %                %       %       %       %            %      %      %
%        %       %         %       %       %       %                %       %       %       %            %      %      %
%        %       %         %       %       %       %                %       %       %       %            %      %      %
%%%%%%%%%%%%%%%%%%%%%%%%%%%%%%%%%%%%%%%%%%%%%%%%%%%%%%%%%%%%%%%%%%%%%%%%%%%%%%%%%%%%%%%%%%%%%%%%%%%%%%%%%%%%%%%%%%%%%%%%