%%%%%%%%%%%%%%%%%%%%%%%%%%%%%%%%%%%%%%%%%%%
%    %         %                         %%
%    %%%%%%%%%%%                         %%
%                                        %%
%                    D                   %%
%                                         %
%                                         %
%%%%%%%  %%%%%%%%%%%%%%%%%%%%%%%%%%%%     %
%     %  %       %         %        %     %
%     %  %       %         %        %     %
%     %  %       %         %        %     %
%     %  %       %         %        %     %
%     %  %       %         %        %     %
%%%%%%%  %%%%%%%%%         %%%%%%%%%%     %
%     %  %       %         %        %     %
%     %  %       %         %        %     %
%     %  %       %         %        %     %
%     %  %       %         %        %     %
%     %  %       %         %        %     %
%     %  %       %         %        %     %
%%%%%%%  %%%%%%%%%%%%%%%%%%%%%%%%%%%%     %
%                                         %
%                                         %
%%%%%%%%%%%%%%%%%%%%%%%%%%%%%%%%%%%%%%%%%%%
%        %       %         %       %      %
%        %       %         %       %      %
%        %       %         %       %      %
%        %       %         %       %      %
%        %       %         %       %      %
%        %       %         %       %      %
%%%%%%%%%%%%%%%%%%%%%%%%%%%%%%%%%%%%%%%%%%%