%%%%%%%%%%%%%%%%%%%%%%%
%          %          %
%          %          %
%          %          %
%          %          %
%          %          %
%          %          %
%          %          %
%%%%%%%%%%%%%%%%%%%%%%%
%          %          %
%          %          %
%          %          %
%          %          %
%          %          %
%          %          %
%          %          %
%%%%%%%%%%%%%%%%%%%%%%%
