%%%%%%%%%%%%%%%%%%%%%%%%
%                      %
%                      %
%                      %
%                      %
%                      %
%                      %
%                      %
%                      %
%                      %
%                      %
%                      %
%                      %
%                      %
%                      %
%                      %
%                      %
%                      %
%                      %
%%%%%%%%%%%%%%%%%%%%%%%%
